########################################
# # # #         #    ## # #            *
# # # # # # # # # #   # # ### ##########
#       # # ##### # ### #              #
# ### # # # #     #     ############## #
# # # # ### # # # ##### ### #        # #
# # # #   #   # # #         # #### ### #
#   ###   #   ### #########   #        #
########################################
