########################################
#.# # #.....    #... ## # #  ..........*
#.# # #.# #.# # #.#.  # # ###.##########
#.......# #.#####.#.### #    ..........#
# ### # # #.#.....#.....##############.#
# # # # ###.#.# # #####.### #......  #.#
# # # #   #...# # #    .....#.####.###.#
#   ###   #   ### #########...#   .....#
########################################
